NO /Users/asalmi/cursus/cub3d/Mandatory/images/wall1.png
SO /Users/asalmi/cursus/cub3d/Mandatory/images/wall1.png
WE /Users/asalmi/cursus/cub3d/Mandatory/images/wall2.png
EA /Users/asalmi/cursus/cub3d/Mandatory/images/wall2.png

F 0,153,76
C 100,183,230

11111111111111111111111111111
10000000001110010000000000001
10110000011101100000000011111
10010000000010000000000001111
11111011101100100110000000001
10000000001100000111011111011
11110111111110111000000000011
11110111111111011101010010N01
11000000110101011100000010001
10000000000000001100001110001
10000000000000001101010010001
11000001110101011111011110001
10000111111111111110000000001
10110111 1110101 101111010001
11111111 1111111 111111111111