NO ./path_to_the_north_texture
SO ./path_to_the_south_texture
WE ./path_to_the_west_texture
EA ./path_to_the_east_texture

F 0,0,0
C 225,30,0



11111111111111111111111111111
10000000001100000000000011111
10110000011100000000000111111
10010000000000000000000011111
11111011101100000111000C000E1
10000000001100000111011111011
11110111111110111000000100011
11110111111111011101010010001
11000000110101011100000010001
10000000000000001100001110001
10000000000000001101010010001
110000011101C1011111011110001
11110111 1110101 101111010001
11111111 1111111 111111111111