NO ./path_to_the_north_texture
SO ./path_to_the_south_texture
WE ./path_to_the_west_texture
EA ./path_to_the_east_texture

F 54,199,242
C 94,157,52





11111111111111111111111111111
10000000001110010000000011111
101100000111C1100000000011111
100100000000100S0000000011111
11111011101100100110000000001
10000000001100000111011111011
11110111111110111000000000011
11110111111111011101010010001
11000000110101011100000010001
10000000000000001100001110001
10000000000000001101010010001
11000001110101011111011110001
10000111111111111110000000001
11110111 1110101 101111010001
11111111 1111111 111111111111